30 30
w w w w w w w w w w w w w w w w w w w w w w w w w w p w w w
w p p p p p p p p w w w w w w w w w w w w w w w w w p w w w
w p w w t w w w p w w w w w w w w w w w w w w w w w p w w w
w p w w k:3 w w w p w w w w w p w w w w w w w p p p p w w w w
w p w w ch w w w p w p p p p p p m:3 p p w w w w p w w w w w w
w p t p p p p p p w w p w w p w w w t w w w w p w w w w w w
w p w w w w w w w w w k:2 t p p w w w p w w w w g:1 w w w w w w
w p p p g:3 p p p p w w w w w p w w w p w w p p p w w w w w w
w w w w w w w w p w w w w w p w w w p p p p e p p p p p p w
w w w w p p p p p p p p m:1 p p w w w w w w p p p w w w w p w
w w w w w w w p w w p w w w p w w w w w w w w p w w w w p w
w w w w w w w w w w p w w w p w w w w w w w w p w w w w t w
w w w p p p p p p t p p p p p p p w w w w w w p w w w w p w
w w w p p p w w w w w w w w p w w w w w w w w p w w w w p w
w w w p p p w w w w w w w w p w w w w w w w w p w w w w p w
w w w w w w w w w w w w p p p p p p w w w w w p p p p p p w
w w w w p w w w w w w w p t p p p p w w w w w p p p p p p w
w w w w p p p w p p p g:2 p p t p p p g:0 p p p p p p p p p p w
w t k:0 p p w p p p w w w p p p p p p w w w w w p p p p p p w
w p w w p w w t w w w w p p p p p p p p p p w p p m:0 p p p w
w p w w m:0 w w w w w w w w w w w p w w w p p w w w w w p w w
w p w w p w w w w w w w w w w w p t p p p p w w w w w t w w
w p w w p w w w w w w w w w w w w w w w p p p p p p p p w w
w p w p w w w p p p p p p t t t w w w w w w w w w w w g:1 w w 
w p p p p p p p p t p w w p p k:1 w w w w w w w w w w w p w w
w p w p w w w p w w w w w p w w w w w w w p p p w w w p w w
w p p p w k:2 w p p p p p w p w w w p p p p p ch p w w w p w w
w p w p w p w w w w w p w p w w w p w w w p p p p p p p w w
w p p m:0 w p p p p p p p p m:3 p p p p p p w w w w w w w w w w
w w w w w w w w w w w w w w w w w w w w w w w w w w w w w w